#,date,month,type,category,debit amount,credit amount,balance
1,02/01/2018,January,debit,Savings,1.16,,389.43
2,02/01/2018,January,debit,Savings,100,,289.43
3,02/01/2018,January,debit,Bills,20.52,,268.91
4,02/01/2018,January,credit,Income (passive),,1.58,270.49
5,02/01/2018,January,debit,Groceries,20,,250.49
6,02/01/2018,January,debit,Clothing,35,,215.49
7,02/01/2018,January,debit,Bills,42,,173.49
8,02/01/2018,January,debit,Clothing,45,,128.49
9,02/01/2018,January,debit,Healthcare,127.5,,0.99
10,02/01/2018,January,debit,Groceries,6.7,,-5.71
11,02/01/2018,January,debit,Going Out,2.99,,-8.7
12,03/01/2018,January,debit,Transport,5.2,,-13.9
13,03/01/2018,January,debit,Going Out,5.99,,-19.89
14,04/01/2018,January,debit,Groceries,4.55,,-24.44
15,05/01/2018,January,debit,Transport,5.2,,-29.64
16,05/01/2018,January,debit,Rent,25.99,,-55.63
17,05/01/2018,January,debit,Groceries,0.9,,-56.53
18,05/01/2018,January,debit,Transport,5.2,,-61.73
19,08/01/2018,January,debit,Entertainment,19.03,,-80.76
20,08/01/2018,January,debit,Coffee,2.2,,-82.96
21,08/01/2018,January,debit,Going Out,6.48,,-89.44
22,08/01/2018,January,debit,Transport,8.6,,-98.04
23,08/01/2018,January,debit,Going Out,11.49,,-109.53
24,09/01/2018,January,debit,Going Out,12.59,,-122.12
25,09/01/2018,January,credit,Income (passive),,1000,877.88
26,09/01/2018,January,debit,Going Out,1.29,,876.59
27,09/01/2018,January,debit,Groceries,2.35,,874.24
28,09/01/2018,January,debit,Transport,3.4,,870.84
29,10/01/2018,January,debit,Savings,2.37,,868.47
30,10/01/2018,January,debit,Going Out,6.87,,861.6
31,10/01/2018,January,debit,Coffee,2.68,,858.92
32,11/01/2018,January,debit,Savings,0.45,,858.47
33,11/01/2018,January,debit,Transport,5.2,,853.27
34,11/01/2018,January,debit,Coffee,5.25,,848.02
35,12/01/2018,January,debit,Savings,1.55,,846.47
36,12/01/2018,January,debit,Coffee,5.65,,840.82
37,12/01/2018,January,debit,Transport,8.6,,832.22
38,12/01/2018,January,debit,Groceries,6.25,,825.97
39,12/01/2018,January,debit,Transport,8.6,,817.37
40,15/01/2018,January,debit,Healthcare,4.98,,812.39
41,15/01/2018,January,debit,Healthcare,210,,602.39
42,15/01/2018,January,debit,Savings,1.92,,600.47
43,15/01/2018,January,debit,Others,40,,560.47
44,15/01/2018,January,debit,Transport,5.2,,555.27
45,15/01/2018,January,debit,Coffee,5.85,,549.42
46,15/01/2018,January,debit,Entertainment,5.99,,543.43
47,16/01/2018,January,debit,Savings,0.96,,542.47
48,16/01/2018,January,debit,Going Out,5.95,,536.52
49,16/01/2018,January,debit,Clothing,39,,497.52
50,16/01/2018,January,debit,Transport,3.4,,494.12
51,16/01/2018,January,debit,Groceries,8.7,,485.42
52,17/01/2018,January,debit,Savings,0.95,,484.47
53,17/01/2018,January,debit,Going Out,5.25,,479.22
54,17/01/2018,January,debit,Healthcare,6.38,,472.84
55,17/01/2018,January,debit,Coffee,2.1,,470.74
56,18/01/2018,January,debit,Savings,2.27,,468.47
57,18/01/2018,January,debit,Transport,8.6,,459.87
58,18/01/2018,January,debit,Entertainment,7.99,,451.88
59,18/01/2018,January,debit,Transport,8.6,,443.28
60,19/01/2018,January,debit,Savings,0.81,,442.47
61,19/01/2018,January,debit,Going Out,4.97,,437.5
62,19/01/2018,January,debit,Transport,5.2,,432.3
63,19/01/2018,January,debit,Going Out,5.67,,426.63
64,19/01/2018,January,debit,Others,8,,418.63
65,22/01/2018,January,debit,Healthcare,3.59,,415.04
66,22/01/2018,January,debit,Coffee,8.85,,406.19
67,22/01/2018,January,debit,Savings,1.72,,404.47
68,22/01/2018,January,debit,Transport,3.4,,401.07
69,22/01/2018,January,debit,Transport,5.2,,395.87
70,22/01/2018,January,debit,Clothing,15.5,,380.37
71,22/01/2018,January,debit,Clothing,15.7,,364.67
72,22/01/2018,January,debit,Healthcare,19,,345.67
73,23/01/2018,January,debit,Savings,2.2,,343.47
74,23/01/2018,January,debit,Groceries,9.9,,333.57
75,23/01/2018,January,debit,Going Out,14.25,,319.32
76,23/01/2018,January,debit,Clothing,43.5,,275.82
77,23/01/2018,January,debit,Coffee,1.6,,274.22
78,23/01/2018,January,debit,Transport,5.2,,269.02
79,23/01/2018,January,debit,Going Out,7.9,,261.12
80,24/01/2018,January,debit,Savings,2.65,,258.47
81,24/01/2018,January,debit,Groceries,16.15,,242.32
82,25/01/2018,January,debit,Savings,0.85,,241.47
83,25/01/2018,January,debit,Going Out,2.99,,238.48
84,26/01/2018,January,debit,Savings,0.01,,238.47
85,26/01/2018,January,debit,Transport,3.4,,235.07
86,26/01/2018,January,debit,Going Out,3.34,,231.73
87,26/01/2018,January,debit,Transport,8.6,,223.13
88,26/01/2018,January,debit,Healthcare,30,,193.13
89,26/01/2018,January,debit,Transport,8.6,,184.53
90,29/01/2018,January,credit,Income (passive),,0.34,184.87
91,29/01/2018,January,debit,Savings,2.06,,182.81
92,29/01/2018,January,debit,Transport,5.2,,177.61
93,29/01/2018,January,debit,Going Out,5.25,,172.36
94,29/01/2018,January,debit,Transport,2.7,,169.66
95,29/01/2018,January,debit,Healthcare,4.8,,164.86
96,29/01/2018,January,debit,Healthcare,9,,155.86
97,29/01/2018,January,debit,Rent,9.58,,146.28
98,29/01/2018,January,debit,Entertainment,49.99,,96.29
99,30/01/2018,January,debit,Savings,2.48,,93.81
100,30/01/2018,January,debit,Going Out,13.95,,79.86
101,30/01/2018,January,debit,Going Out,39.16,,40.7
102,30/01/2018,January,debit,Going Out,3.54,,37.16
103,30/01/2018,January,debit,Transport,8.6,,28.56
104,30/01/2018,January,debit,Going Out,13.5,,15.06
105,30/01/2018,January,credit,Income (passive),,100,115.06
106,31/01/2018,January,credit,Income (active),,371.8,486.86
107,31/01/2018,January,debit,Savings,2.25,,484.61
108,31/01/2018,January,debit,Going Out,8.2,,476.41
109,31/01/2018,January,debit,Going Out,3.89,,472.52
110,31/01/2018,January,debit,Transport,8.6,,463.92
111,01/02/2018,February,debit,Savings,1.31,,462.61
112,01/02/2018,February,debit,Entertainment,10.73,,451.88
113,01/02/2018,February,debit,Others,0.32,,451.56
114,01/02/2018,February,debit,Others,0.5,,451.06
115,01/02/2018,February,debit,Healthcare,14.98,,436.08
116,01/02/2018,February,debit,Bills,20.52,,415.56
117,01/02/2018,February,debit,Coffee,6,,409.56
118,01/02/2018,February,debit,Going Out,7.65,,401.91
119,01/02/2018,February,debit,Transport,8.6,,393.31
120,01/02/2018,February,debit,Clothing,23.85,,369.46
121,02/02/2018,February,debit,Savings,1.19,,368.27
122,02/02/2018,February,debit,Savings,100,,268.27
123,02/02/2018,February,debit,Healthcare,6.62,,261.65
124,02/02/2018,February,debit,Groceries,0.68,,260.97
125,02/02/2018,February,debit,Going Out,5.95,,255.02
126,02/02/2018,February,debit,Transport,8.6,,246.42
127,02/02/2018,February,debit,Clothing,19.99,,226.43
128,05/02/2018,February,credit,Income (active),,1159.6,1386.03
129,05/02/2018,February,debit,Savings,1.16,,1384.87
130,05/02/2018,February,debit,Transport,5.2,,1379.67
131,05/02/2018,February,debit,Groceries,5.32,,1374.35
132,05/02/2018,February,debit,Going Out,19.99,,1354.36
133,05/02/2018,February,debit,Transport,3.4,,1350.96
134,05/02/2018,February,debit,Clothing,10,,1340.96
135,05/02/2018,February,debit,Rent,15.88,,1325.08
136,05/02/2018,February,debit,Going Out,28.13,,1296.95
137,05/02/2018,February,debit,Transport,3.4,,1293.55
138,05/02/2018,February,debit,Going Out,5.77,,1287.78
139,05/02/2018,February,debit,Savings,500,,787.78
140,06/02/2018,February,debit,Savings,3.91,,783.87
141,06/02/2018,February,debit,Clothing,42,,741.87
142,06/02/2018,February,debit,Going Out,21.4,,720.47
143,06/02/2018,February,debit,Going Out,27.45,,693.02
144,07/02/2018,February,debit,Savings,1.15,,691.87
145,07/02/2018,February,debit,Transport,3.4,,688.47
146,07/02/2018,February,debit,Going Out,7.24,,681.23
147,07/02/2018,February,debit,Coffee,2,,679.23
148,07/02/2018,February,debit,Coffee,3.65,,675.58
149,08/02/2018,February,debit,Savings,1.71,,673.87
150,08/02/2018,February,debit,Going Out,1.99,,671.88
151,08/02/2018,February,debit,Going Out,2.35,,669.53
152,08/02/2018,February,debit,Healthcare,50,,619.53
153,08/02/2018,February,debit,Transport,8.6,,610.93
154,08/02/2018,February,debit,Coffee,3.2,,607.73
155,09/02/2018,February,debit,Savings,1.86,,605.87
156,09/02/2018,February,debit,Going Out,1.95,,603.92
157,09/02/2018,February,debit,Transport,5.2,,598.72
158,09/02/2018,February,debit,Clothing,13.43,,585.29
159,09/02/2018,February,credit,Income (passive),,8.5,593.79
160,09/02/2018,February,credit,Income (passive),,7.5,601.29
161,09/02/2018,February,debit,Going Out,4.1,,597.19
162,09/02/2018,February,debit,Going Out,7.25,,589.94
163,09/02/2018,February,debit,Entertainment,18.33,,571.61
164,09/02/2018,February,credit,Income (passive),,9.99,581.6
165,12/02/2018,February,debit,Transport,8.6,,573
166,12/02/2018,February,debit,Savings,4.14,,568.86
167,12/02/2018,February,debit,Transport,3.4,,565.46
168,12/02/2018,February,debit,Going Out,3.75,,561.71
169,12/02/2018,February,debit,Healthcare,15.07,,546.64
170,12/02/2018,February,debit,Healthcare,17.2,,529.44
171,12/02/2018,February,debit,Transport,4.9,,524.54
172,12/02/2018,February,debit,Going Out,66.71,,457.83
173,13/02/2018,February,debit,Savings,2.97,,454.86
174,13/02/2018,February,debit,Coffee,3.45,,451.41
175,13/02/2018,February,debit,Going Out,8.48,,442.93
176,13/02/2018,February,debit,Coffee,2.2,,440.73
177,13/02/2018,February,debit,Going Out,5.75,,434.98
178,14/02/2018,February,debit,Savings,2.12,,432.86
179,14/02/2018,February,debit,Transport,8.6,,424.26
180,14/02/2018,February,debit,Going Out,9.59,,414.67
181,14/02/2018,February,debit,Entertainment,1.45,,413.22
182,14/02/2018,February,debit,Others,0.04,,413.18
183,14/02/2018,February,debit,Others,0.5,,412.68
184,14/02/2018,February,debit,Entertainment,5.99,,406.69
185,15/02/2018,February,debit,Savings,1.37,,405.32
186,16/02/2018,February,debit,Coffee,12.91,,392.41
187,16/02/2018,February,debit,Others,0.38,,392.03
188,16/02/2018,February,debit,Others,0.5,,391.53
189,16/02/2018,February,debit,Transport,19.76,,371.77
190,16/02/2018,February,debit,Bills,89.99,,281.78
191,19/02/2018,February,debit,Clothing,12.45,,269.33
192,19/02/2018,February,debit,Savings,0.89,,268.44
193,19/02/2018,February,debit,Transport,5.2,,263.24
194,19/02/2018,February,debit,Coffee,6.2,,257.04
195,19/02/2018,February,debit,Going Out,8.08,,248.96
196,19/02/2018,February,debit,Going Out,9.15,,239.81
197,19/02/2018,February,debit,Going Out,11.6,,228.21
198,19/02/2018,February,debit,Going Out,3.18,,225.03
199,19/02/2018,February,debit,Entertainment,7.99,,217.04
200,19/02/2018,February,debit,Transport,3.4,,213.64
201,19/02/2018,February,debit,Rent,27.49,,186.15
202,20/02/2018,February,debit,Savings,5.71,,180.44
203,20/02/2018,February,debit,Going Out,52.3,,128.14
204,21/02/2018,February,debit,Savings,0.7,,127.44
205,21/02/2018,February,debit,Transport,8.6,,118.84
206,21/02/2018,February,debit,Transport,6.8,,112.04
207,21/02/2018,February,debit,Going Out,8.04,,104
208,22/02/2018,February,debit,Savings,1.56,,102.44
209,22/02/2018,February,credit,Income (passive),,250,352.44
210,22/02/2018,February,debit,Healthcare,50,,302.44
211,22/02/2018,February,debit,Coffee,2.75,,299.69
212,22/02/2018,February,debit,Groceries,4.63,,295.06
213,22/02/2018,February,debit,Going Out,5,,290.06
214,23/02/2018,February,debit,Savings,0.62,,289.44
215,23/02/2018,February,debit,Transport,8.6,,280.84
216,23/02/2018,February,debit,Clothing,43.85,,236.99
217,23/02/2018,February,debit,Healthcare,10,,226.99
218,23/02/2018,February,debit,Transport,8.6,,218.39
219,26/02/2018,February,debit,Savings,0.95,,217.44
220,26/02/2018,February,debit,Coffee,2.2,,215.24
221,26/02/2018,February,debit,Transport,5.2,,210.04
222,26/02/2018,February,debit,Entertainment,6.03,,204.01
223,26/02/2018,February,debit,Rent,8.99,,195.02
224,26/02/2018,February,debit,Rent,18.48,,176.54
225,26/02/2018,February,debit,Clothing,3.5,,173.04
226,26/02/2018,February,debit,Going Out,10.8,,162.24
227,26/02/2018,February,debit,Clothing,17.7,,144.54
228,26/02/2018,February,debit,Clothing,44.03,,100.51
229,27/02/2018,February,debit,Savings,5.07,,95.44
230,27/02/2018,February,debit,Coffee,6.9,,88.54
231,27/02/2018,February,debit,Clothing,26.75,,61.79
232,27/02/2018,February,debit,Healthcare,9.24,,52.55
233,27/02/2018,February,credit,Income (passive),,30,82.55
234,27/02/2018,February,debit,Healthcare,50,,32.55
235,27/02/2018,February,debit,Entertainment,2.2,,30.35
236,27/02/2018,February,debit,Going Out,4.25,,26.1
237,27/02/2018,February,debit,Going Out,5.25,,20.85
238,28/02/2018,February,credit,Income (active),,1392.28,1413.13
239,28/02/2018,February,debit,Savings,3.41,,1409.72
240,28/02/2018,February,debit,Transport,8.6,,1401.12
241,28/02/2018,February,debit,Groceries,2.55,,1398.57
242,28/02/2018,February,debit,Transport,8.6,,1389.97
243,01/03/2018,March,debit,Savings,1.25,,1388.72
244,01/03/2018,March,debit,Coffee,5.3,,1383.42
245,01/03/2018,March,debit,Clothing,7.5,,1375.92
246,01/03/2018,March,debit,Rent,5.25,,1370.67
247,02/03/2018,March,debit,Savings,1.95,,1368.72
248,02/03/2018,March,debit,Savings,100,,1268.72
249,02/03/2018,March,debit,Groceries,2.3,,1266.42
250,02/03/2018,March,credit,Income (passive),,200,1466.42
251,02/03/2018,March,debit,Rent,400,,1066.42
252,05/03/2018,March,debit,Savings,0.7,,1065.72
253,05/03/2018,March,debit,Bills,19,,1046.72
254,05/03/2018,March,debit,Bills,63.68,,983.04
255,05/03/2018,March,debit,Groceries,3.5,,979.54
256,05/03/2018,March,debit,Coffee,5.15,,974.39
257,05/03/2018,March,debit,Transport,5.2,,969.19
258,05/03/2018,March,debit,Going Out,14.2,,954.99
259,05/03/2018,March,debit,Entertainment,3.73,,951.26
260,05/03/2018,March,debit,Going Out,33.2,,918.06
261,05/03/2018,March,debit,Transport,34.9,,883.16
262,06/03/2018,March,debit,Savings,4.12,,879.04
263,06/03/2018,March,debit,Going Out,16.79,,862.25
264,06/03/2018,March,debit,Going Out,2.88,,859.37
265,06/03/2018,March,debit,Rent,10.99,,848.38
266,07/03/2018,March,debit,Savings,0.34,,848.04
267,07/03/2018,March,debit,Clothing,28,,820.04
268,07/03/2018,March,debit,Coffee,3.2,,816.84
269,07/03/2018,March,debit,Coffee,3.9,,812.94
270,07/03/2018,March,debit,Transport,8.6,,804.34
271,08/03/2018,March,debit,Savings,1.3,,803.04
272,08/03/2018,March,debit,Going Out,1.99,,801.05
273,08/03/2018,March,debit,Healthcare,14.44,,786.61
274,08/03/2018,March,debit,Coffee,2.75,,783.86
275,08/03/2018,March,debit,Transport,8.6,,775.26
276,09/03/2018,March,debit,Savings,1.22,,774.04
277,09/03/2018,March,debit,Going Out,6.49,,767.55
278,09/03/2018,March,debit,Coffee,6.04,,761.51
279,12/03/2018,March,debit,Going Out,9.59,,751.92
280,12/03/2018,March,debit,Savings,1.88,,750.04
281,12/03/2018,March,debit,Going Out,4.65,,745.39
282,12/03/2018,March,debit,Coffee,2.6,,742.79
283,12/03/2018,March,debit,Transport,5.2,,737.59
284,12/03/2018,March,debit,Going Out,8.19,,729.4
285,12/03/2018,March,debit,Clothing,4.6,,724.8
286,12/03/2018,March,debit,Transport,6.8,,718
287,12/03/2018,March,debit,Going Out,13.7,,704.3
288,12/03/2018,March,debit,Going Out,14.5,,689.8
289,12/03/2018,March,debit,Going Out,30.01,,659.79
290,12/03/2018,March,debit,Entertainment,7.99,,651.8
291,13/03/2018,March,debit,Savings,4.76,,647.04
292,13/03/2018,March,debit,Transport,8.6,,638.44
293,13/03/2018,March,debit,Going Out,17.08,,621.36
294,13/03/2018,March,debit,Healthcare,200,,421.36
295,14/03/2018,March,debit,Savings,1.32,,420.04
296,14/03/2018,March,debit,Groceries,3.05,,416.99
297,14/03/2018,March,debit,Going Out,3.89,,413.1
298,14/03/2018,March,debit,Entertainment,5.99,,407.11
299,14/03/2018,March,credit,Income (passive),,20,427.11
300,15/03/2018,March,debit,Savings,1.07,,426.04
301,15/03/2018,March,debit,Transport,3.4,,422.64
302,15/03/2018,March,debit,Transport,8.6,,414.04
303,15/03/2018,March,debit,Coffee,7.25,,406.79
304,15/03/2018,March,debit,Transport,8.6,,398.19
305,15/03/2018,March,debit,Going Out,9.1,,389.09
306,15/03/2018,March,debit,Rent,14.13,,374.96
307,15/03/2018,March,debit,Clothing,17.8,,357.16
308,16/03/2018,March,debit,Savings,4.12,,353.04
309,16/03/2018,March,debit,Healthcare,50,,303.04
310,19/03/2018,March,debit,Transport,10.4,,292.64
311,19/03/2018,March,debit,Entertainment,1.99,,290.65
312,19/03/2018,March,debit,Coffee,3.95,,286.7
313,19/03/2018,March,debit,Coffee,5.64,,281.06
314,19/03/2018,March,debit,Going Out,7.79,,273.27
315,19/03/2018,March,debit,Entertainment,7.99,,265.28
316,19/03/2018,March,debit,Clothing,10.75,,254.53
317,19/03/2018,March,debit,Clothing,15,,239.53
318,19/03/2018,March,debit,Clothing,39.99,,199.54
319,20/03/2018,March,debit,Savings,1.5,,198.04
320,20/03/2018,March,debit,Transport,8.6,,189.44
321,20/03/2018,March,debit,Transport,5.2,,184.24
322,21/03/2018,March,debit,Savings,1.2,,183.04
323,21/03/2018,March,debit,Going Out,22.28,,160.76
324,21/03/2018,March,debit,Healthcare,20,,140.76
325,21/03/2018,March,debit,Going Out,3.49,,137.27
326,21/03/2018,March,debit,Going Out,6.59,,130.68
327,21/03/2018,March,debit,Transport,8.6,,122.08
328,22/03/2018,March,debit,Savings,2.04,,120.04
329,22/03/2018,March,credit,Income (passive),,130,250.04
330,23/03/2018,March,debit,Going Out,9.7,,240.34
331,23/03/2018,March,debit,Coffee,3.45,,236.89
332,23/03/2018,March,debit,Going Out,4.25,,232.64
333,23/03/2018,March,debit,Going Out,5.98,,226.66
334,23/03/2018,March,debit,Going Out,13.05,,213.61
335,23/03/2018,March,debit,Going Out,16.24,,197.37
336,26/03/2018,March,debit,Healthcare,50,,147.37
337,26/03/2018,March,debit,Others,15,,132.37
338,26/03/2018,March,debit,Going Out,10,,122.37
339,26/03/2018,March,debit,Savings,3.33,,119.04
340,26/03/2018,March,debit,Transport,8.6,,110.44
341,26/03/2018,March,debit,Coffee,2.2,,108.24
342,26/03/2018,March,debit,Transport,5.2,,103.04
343,26/03/2018,March,debit,Going Out,3,,100.04
344,26/03/2018,March,debit,Groceries,4.2,,95.84
345,26/03/2018,March,debit,Groceries,5.62,,90.22
346,27/03/2018,March,debit,Savings,3.18,,87.04
347,27/03/2018,March,debit,Going Out,12.78,,74.26
348,27/03/2018,March,credit,Income (passive),,100,174.26
349,27/03/2018,March,debit,Healthcare,20,,154.26
350,27/03/2018,March,debit,Going Out,22.5,,131.76
351,27/03/2018,March,debit,Transport,3.4,,128.36
352,28/03/2018,March,debit,Savings,1.32,,127.04
353,28/03/2018,March,debit,Going Out,7.78,,119.26
354,28/03/2018,March,debit,Going Out,1.85,,117.41
355,28/03/2018,March,debit,Coffee,3.2,,114.21
356,28/03/2018,March,debit,Transport,5.2,,109.01
357,28/03/2018,March,debit,Savings,100,,9.01
358,29/03/2018,March,credit,Income (active),,1763.9,1772.91
359,29/03/2018,March,debit,Savings,250,,1522.91
360,29/03/2018,March,debit,Savings,1.97,,1520.94
361,29/03/2018,March,debit,Entertainment,18.99,,1501.95
362,03/04/2018,April,debit,Savings,0.01,,1501.94
363,03/04/2018,April,debit,Savings,100,,1401.94
364,03/04/2018,April,debit,Savings,250,,1151.94
365,03/04/2018,April,debit,Healthcare,60,,1091.94
366,03/04/2018,April,debit,Going Out,3.09,,1088.85
367,03/04/2018,April,debit,Going Out,23.95,,1064.9
368,03/04/2018,April,debit,Going Out,49.05,,1015.85
369,04/04/2018,April,debit,Savings,1.91,,1013.94
370,04/04/2018,April,debit,Bills,19,,994.94
371,04/04/2018,April,debit,Bills,29,,965.94
372,04/04/2018,April,debit,Transport,3,,962.94
373,04/04/2018,April,debit,Going Out,4.59,,958.35
374,04/04/2018,April,debit,Going Out,6.75,,951.6
375,04/04/2018,April,debit,Groceries,8.5,,943.1
376,05/04/2018,April,debit,Savings,1.16,,941.94
377,05/04/2018,April,debit,Groceries,1,,940.94
378,05/04/2018,April,debit,Transport,8.6,,932.34
379,05/04/2018,April,debit,Clothing,32.85,,899.49
380,06/04/2018,April,debit,Savings,0.55,,898.94
381,06/04/2018,April,debit,Clothing,28,,870.94
382,06/04/2018,April,debit,Healthcare,20,,850.94
383,06/04/2018,April,debit,Transport,8.6,,842.34
384,09/04/2018,April,debit,Coffee,4,,838.34
385,09/04/2018,April,debit,Savings,0.4,,837.94
386,09/04/2018,April,debit,Going Out,1.49,,836.45
387,09/04/2018,April,debit,Transport,5.2,,831.25
388,09/04/2018,April,debit,Going Out,18.25,,813
389,10/04/2018,April,debit,Savings,2.06,,810.94
390,10/04/2018,April,debit,Going Out,6.95,,803.99
391,10/04/2018,April,debit,Transport,3.4,,800.59
392,10/04/2018,April,debit,Rent,150,,650.59
393,11/04/2018,April,debit,Savings,0.65,,649.94
394,11/04/2018,April,debit,Healthcare,50,,599.94
395,11/04/2018,April,debit,Transport,8.6,,591.34
396,12/04/2018,April,debit,Savings,0.4,,590.94
397,12/04/2018,April,debit,Clothing,16,,574.94
398,12/04/2018,April,debit,Coffee,1.7,,573.24
399,12/04/2018,April,debit,Groceries,2.95,,570.29
400,12/04/2018,April,debit,Clothing,5.8,,564.49
401,13/04/2018,April,debit,Savings,0.55,,563.94
402,13/04/2018,April,debit,Transport,8.6,,555.34
403,13/04/2018,April,debit,Coffee,5.15,,550.19
404,13/04/2018,April,debit,Groceries,9.5,,540.69
405,16/04/2018,April,debit,Healthcare,40,,500.69
406,16/04/2018,April,debit,Savings,1.75,,498.94
407,16/04/2018,April,debit,Transport,8.6,,490.34
408,16/04/2018,April,debit,Entertainment,5.99,,484.35
409,16/04/2018,April,debit,Going Out,7.53,,476.82
410,16/04/2018,April,debit,Going Out,8.1,,468.72
411,16/04/2018,April,debit,Others,5,,463.72
412,16/04/2018,April,debit,Going Out,13.94,,449.78
413,16/04/2018,April,debit,Groceries,1,,448.78
414,16/04/2018,April,debit,Groceries,7,,441.78
415,16/04/2018,April,debit,Clothing,22.03,,419.75
416,16/04/2018,April,debit,Clothing,23.73,,396.02
417,16/04/2018,April,debit,Clothing,44.65,,351.37
418,17/04/2018,April,debit,Savings,3.43,,347.94
419,17/04/2018,April,debit,Transport,8.6,,339.34
420,17/04/2018,April,debit,Clothing,13,,326.34
421,17/04/2018,April,debit,Groceries,1.65,,324.69
422,17/04/2018,April,debit,Transport,8.6,,316.09
423,17/04/2018,April,debit,Healthcare,100,,216.09
424,18/04/2018,April,debit,Savings,1.15,,214.94
425,18/04/2018,April,debit,Entertainment,22.38,,192.56
426,18/04/2018,April,debit,Going Out,3.78,,188.78
427,18/04/2018,April,debit,Going Out,6,,182.78
428,18/04/2018,April,debit,Groceries,8.3,,174.48
429,19/04/2018,April,debit,Savings,1.54,,172.94
430,19/04/2018,April,debit,Transport,11.6,,161.34
431,19/04/2018,April,debit,Going Out,6.99,,154.35
432,19/04/2018,April,debit,Clothing,23.04,,131.31
433,20/04/2018,April,debit,Savings,1.37,,129.94
434,20/04/2018,April,debit,Entertainment,7.99,,121.95
435,20/04/2018,April,debit,Coffee,3.2,,118.75
436,20/04/2018,April,debit,Going Out,18.22,,100.53
437,23/04/2018,April,debit,Savings,1.59,,98.94
438,23/04/2018,April,credit,Income (passive),,137.61,236.55
439,23/04/2018,April,debit,Transport,8.6,,227.95
440,23/04/2018,April,debit,Going Out,3.89,,224.06
441,23/04/2018,April,debit,Transport,5.2,,218.86
442,23/04/2018,April,debit,Groceries,6.15,,212.71
443,23/04/2018,April,debit,Entertainment,0.19,,212.52
444,24/04/2018,April,debit,Savings,2.97,,209.55
445,24/04/2018,April,debit,Going Out,21.98,,187.57
446,24/04/2018,April,debit,Healthcare,10,,177.57
447,24/04/2018,April,debit,Transport,5.5,,172.07
448,24/04/2018,April,debit,Going Out,20.45,,151.62
449,24/04/2018,April,debit,Groceries,2.15,,149.47
450,25/04/2018,April,debit,Savings,1.92,,147.55
451,25/04/2018,April,debit,Transport,5.2,,142.35
452,25/04/2018,April,debit,Others,0.89,,141.46
453,25/04/2018,April,debit,Coffee,2.95,,138.51
454,25/04/2018,April,debit,Clothing,12,,126.51
455,25/04/2018,April,debit,Going Out,13,,113.51
456,25/04/2018,April,debit,Healthcare,14.58,,98.93
457,25/04/2018,April,debit,Healthcare,25,,73.93
458,26/04/2018,April,debit,Savings,1.38,,72.55
459,26/04/2018,April,debit,Healthcare,60,,12.55
460,26/04/2018,April,debit,Groceries,3.2,,9.35
461,27/04/2018,April,debit,Savings,0.8,,8.55
462,27/04/2018,April,debit,Transport,3.4,,5.15
463,27/04/2018,April,credit,Income (passive),,200,205.15
464,27/04/2018,April,debit,Coffee,4.65,,200.5
465,30/04/2018,April,debit,Transport,8.6,,191.9
466,30/04/2018,April,credit,Income (active),,1480.44,1672.34
467,30/04/2018,April,debit,Savings,1.35,,1670.99
468,30/04/2018,April,debit,Transport,5.2,,1665.79
469,30/04/2018,April,debit,Transport,8.6,,1657.19
470,30/04/2018,April,debit,Going Out,8.75,,1648.44
471,30/04/2018,April,debit,Going Out,22.35,,1626.09
472,30/04/2018,April,debit,Rent,150,,1476.09
473,30/04/2018,April,debit,Savings,200,,1276.09
474,01/05/2018,May,debit,Savings,2.1,,1273.99
475,01/05/2018,May,debit,Savings,250,,1023.99
476,01/05/2018,May,debit,Going Out,25.32,,998.67
477,01/05/2018,May,debit,Clothing,17.94,,980.73
478,02/05/2018,May,debit,Savings,0.74,,979.99
479,02/05/2018,May,debit,Savings,100,,879.99
480,02/05/2018,May,debit,Bills,19,,860.99
481,02/05/2018,May,debit,Bills,30.36,,830.63
482,03/05/2018,May,debit,Transport,5.2,,825.43
483,03/05/2018,May,debit,Healthcare,40,,785.43
484,03/05/2018,May,debit,Healthcare,20,,765.43
485,03/05/2018,May,debit,Clothing,56,,709.43
486,03/05/2018,May,debit,Healthcare,118,,591.43
487,04/05/2018,May,debit,Savings,0.8,,590.63
488,04/05/2018,May,debit,Going Out,2.4,,588.23
489,04/05/2018,May,debit,Transport,5.2,,583.03
490,04/05/2018,May,debit,Transport,5.2,,577.83
491,04/05/2018,May,debit,Healthcare,30,,547.83
492,08/05/2018,May,debit,Clothing,44.03,,503.8
493,08/05/2018,May,credit,Income (passive),,2500,3003.8
494,08/05/2018,May,credit,Income (passive),,2500,5503.8
495,08/05/2018,May,debit,Savings,5000,,503.8
496,08/05/2018,May,debit,Savings,3.17,,500.63
497,08/05/2018,May,debit,Going Out,1.25,,499.38
498,08/05/2018,May,debit,Transport,5.2,,494.18
499,08/05/2018,May,debit,Going Out,10.2,,483.98
500,08/05/2018,May,debit,Transport,3.4,,480.58
501,08/05/2018,May,debit,Going Out,10.2,,470.38
502,08/05/2018,May,debit,Going Out,10.4,,459.98
503,09/05/2018,May,debit,Savings,4.35,,455.63
504,09/05/2018,May,debit,Going Out,10.25,,445.38
505,09/05/2018,May,debit,Going Out,16.5,,428.88
506,09/05/2018,May,debit,Rent,7.99,,420.89
507,09/05/2018,May,debit,Others,13.99,,406.9
508,09/05/2018,May,debit,Rent,26.98,,379.92
509,10/05/2018,May,debit,Savings,1.29,,378.63
510,10/05/2018,May,debit,Transport,5.2,,373.43
511,10/05/2018,May,debit,Clothing,46.3,,327.13
512,10/05/2018,May,debit,Going Out,3.05,,324.08
513,10/05/2018,May,debit,Healthcare,4.94,,319.14
514,11/05/2018,May,debit,Savings,2.51,,316.63
515,11/05/2018,May,debit,Entertainment,0.04,,316.59
516,11/05/2018,May,debit,Coffee,2,,314.59
517,11/05/2018,May,debit,Transport,5.2,,309.39
518,11/05/2018,May,debit,Going Out,14.98,,294.41
519,11/05/2018,May,debit,Entertainment,49.21,,245.2
520,14/05/2018,May,debit,Transport,5.2,,240
521,14/05/2018,May,debit,Savings,3.37,,236.63
522,14/05/2018,May,debit,Coffee,5.15,,231.48
523,14/05/2018,May,debit,Transport,5.2,,226.28
524,14/05/2018,May,debit,Going Out,10.2,,216.08
525,14/05/2018,May,debit,Going Out,14.2,,201.88
526,14/05/2018,May,debit,Going Out,0.99,,200.89
527,14/05/2018,May,debit,Entertainment,5.99,,194.9
528,14/05/2018,May,debit,Rent,20.98,,173.92
529,14/05/2018,May,debit,Going Out,34.9,,139.02
530,14/05/2018,May,debit,Going Out,45.3,,93.72
531,15/05/2018,May,debit,Savings,4.09,,89.63
532,15/05/2018,May,debit,Rent,25.73,,63.9
533,15/05/2018,May,credit,Income (passive),,760.7,824.6
534,15/05/2018,May,debit,Transport,3.4,,821.2
535,15/05/2018,May,debit,Entertainment,4.94,,816.26
536,16/05/2018,May,debit,Savings,0.93,,815.33
537,16/05/2018,May,debit,Going Out,8.49,,806.84
538,16/05/2018,May,credit,Income (passive),,133,939.84
539,16/05/2018,May,debit,Healthcare,40,,899.84
540,16/05/2018,May,debit,Groceries,4,,895.84
541,16/05/2018,May,debit,Transport,5.2,,890.64
542,17/05/2018,May,debit,Savings,1.31,,889.33
543,17/05/2018,May,debit,Going Out,5.44,,883.89
544,17/05/2018,May,debit,Coffee,5.8,,878.09
545,17/05/2018,May,debit,Transport,5.2,,872.89
546,17/05/2018,May,debit,Going Out,14.05,,858.84
547,17/05/2018,May,debit,Transport,265.96,,592.88
548,18/05/2018,May,debit,Savings,2.55,,590.33
549,18/05/2018,May,debit,Groceries,2.8,,587.53
550,18/05/2018,May,debit,Entertainment,7.99,,579.54
551,18/05/2018,May,debit,Transport,8.6,,570.94
552,18/05/2018,May,debit,Groceries,11.2,,559.74
553,21/05/2018,May,debit,Groceries,8.17,,551.57
554,21/05/2018,May,debit,Savings,2.24,,549.33
555,21/05/2018,May,debit,Rent,2.68,,546.65
556,21/05/2018,May,debit,Coffee,4,,542.65
557,21/05/2018,May,debit,Transport,8.6,,534.05
558,21/05/2018,May,debit,Rent,6.66,,527.39
559,21/05/2018,May,debit,Groceries,25.78,,501.61
560,21/05/2018,May,credit,Income (passive),,50,551.61
561,22/05/2018,May,debit,Savings,1.28,,550.33
562,22/05/2018,May,debit,Going Out,18.7,,531.63
563,22/05/2018,May,debit,Groceries,4.3,,527.33
564,22/05/2018,May,debit,Groceries,8.4,,518.93
565,22/05/2018,May,debit,Transport,8.6,,510.33
566,23/05/2018,May,debit,Savings,2,,508.33
567,23/05/2018,May,debit,Others,47.95,,460.38
568,23/05/2018,May,debit,Groceries,2,,458.38
569,24/05/2018,May,debit,Savings,0.05,,458.33
570,24/05/2018,May,debit,Transport,8.6,,449.73
571,24/05/2018,May,debit,Groceries,3.7,,446.03
572,24/05/2018,May,debit,Going Out,7.9,,438.13
573,24/05/2018,May,debit,Going Out,8.4,,429.73
574,24/05/2018,May,debit,Going Out,8.4,,421.33
575,24/05/2018,May,debit,Going Out,18.58,,402.75
576,24/05/2018,May,debit,Going Out,41.75,,361
577,25/05/2018,May,debit,Savings,2.67,,358.33
578,25/05/2018,May,debit,Rent,2.52,,355.81
579,25/05/2018,May,debit,Transport,3.4,,352.41
580,25/05/2018,May,debit,Rent,9.3,,343.11
581,25/05/2018,May,debit,Going Out,10.08,,333.03
582,25/05/2018,May,debit,Rent,13.92,,319.11
583,25/05/2018,May,debit,Rent,19.99,,299.12
584,25/05/2018,May,debit,Rent,50.61,,248.51
585,25/05/2018,May,debit,Rent,74.03,,174.48
586,29/05/2018,May,debit,Transport,5.2,,169.28
587,29/05/2018,May,credit,Income (passive),,135.45,304.73
588,29/05/2018,May,credit,Income (passive),,0.05,304.78
589,29/05/2018,May,debit,Savings,4.95,,299.83
590,29/05/2018,May,debit,Going Out,6.35,,293.48
591,29/05/2018,May,debit,Transport,11.6,,281.88
592,29/05/2018,May,debit,Going Out,12.8,,269.08
593,29/05/2018,May,debit,Going Out,28.4,,240.68
594,29/05/2018,May,debit,Going Out,5.2,,235.48
595,29/05/2018,May,debit,Transport,47.03,,188.45
596,29/05/2018,May,debit,Groceries,10.36,,178.09
597,29/05/2018,May,debit,Going Out,3.5,,174.59
598,29/05/2018,May,debit,Clothing,10.9,,163.69
599,29/05/2018,May,debit,Clothing,43.02,,120.67
600,30/05/2018,May,debit,Savings,5.84,,114.83
601,30/05/2018,May,debit,Clothing,38,,76.83
602,30/05/2018,May,debit,Clothing,45,,31.83
603,30/05/2018,May,debit,Groceries,4.35,,27.48
604,30/05/2018,May,debit,Transport,8.6,,18.88
605,30/05/2018,May,debit,Going Out,11.6,,7.28
606,30/05/2018,May,credit,Income (passive),,100,107.28
607,30/05/2018,May,debit,Healthcare,50,,57.28
608,31/05/2018,May,debit,Healthcare,10,,47.28
609,31/05/2018,May,credit,Income (active),,1482.74,1530.02
610,31/05/2018,May,debit,Savings,1.45,,1528.57
611,31/05/2018,May,debit,Healthcare,2.99,,1525.58
612,31/05/2018,May,debit,Going Out,3.99,,1521.59
613,31/05/2018,May,debit,Transport,8.6,,1512.99
614,01/06/2018,June,debit,Savings,0.42,,1512.57
615,01/06/2018,June,debit,Savings,250,,1262.57
616,01/06/2018,June,debit,Groceries,13.99,,1248.58
617,01/06/2018,June,debit,Bills,19,,1229.58
618,01/06/2018,June,debit,Bills,30.36,,1199.22
619,01/06/2018,June,credit,Income (passive),,567.58,1766.8
620,01/06/2018,June,debit,Going Out,5.95,,1760.85
621,01/06/2018,June,debit,Going Out,9.4,,1751.45
622,01/06/2018,June,debit,Clothing,11.99,,1739.46
623,04/06/2018,June,debit,Savings,350,,1389.46
624,04/06/2018,June,debit,Healthcare,60,,1329.46
625,04/06/2018,June,debit,Savings,0.67,,1328.79
626,04/06/2018,June,debit,Savings,100,,1228.79
627,04/06/2018,June,debit,Clothing,16.2,,1212.59
628,04/06/2018,June,debit,Coffee,9.18,,1203.41
629,04/06/2018,June,debit,Going Out,6,,1197.41
630,04/06/2018,June,debit,Clothing,7,,1190.41
631,04/06/2018,June,debit,Going Out,17,,1173.41
632,04/06/2018,June,debit,Going Out,22.17,,1151.24
633,05/06/2018,June,debit,Savings,2.45,,1148.79
634,05/06/2018,June,debit,Rent,25.3,,1123.49
635,05/06/2018,June,debit,Clothing,33,,1090.49
636,05/06/2018,June,debit,Savings,100,,990.49
637,06/06/2018,June,debit,Savings,0.7,,989.79
638,06/06/2018,June,debit,Healthcare,50,,939.79
639,06/06/2018,June,debit,Clothing,25,,914.79
640,06/06/2018,June,debit,Clothing,42,,872.79
641,06/06/2018,June,debit,Going Out,4.29,,868.5
642,06/06/2018,June,debit,Coffee,4.6,,863.9
643,06/06/2018,June,debit,Going Out,5.6,,858.3
644,06/06/2018,June,debit,Transport,8.6,,849.7
645,06/06/2018,June,debit,Transport,100,,749.7
646,07/06/2018,June,debit,Savings,1.91,,747.79
647,07/06/2018,June,debit,Transport,5.2,,742.59
648,07/06/2018,June,debit,Rent,16.95,,725.64
649,08/06/2018,June,debit,Savings,0.85,,724.79
650,08/06/2018,June,debit,Going Out,19.58,,705.21
651,08/06/2018,June,debit,Others,13.99,,691.22
652,08/06/2018,June,debit,Groceries,3.5,,687.72
653,08/06/2018,June,debit,Coffee,4.65,,683.07
654,11/06/2018,June,debit,Savings,1.27,,681.8
655,11/06/2018,June,debit,Transport,5.2,,676.6
656,11/06/2018,June,debit,Going Out,5.75,,670.85
657,11/06/2018,June,debit,Going Out,10.2,,660.65
658,11/06/2018,June,debit,Going Out,20.25,,640.4
659,11/06/2018,June,debit,Transport,3.4,,637
660,11/06/2018,June,debit,Going Out,6.1,,630.9
661,11/06/2018,June,debit,Clothing,45,,585.9
662,11/06/2018,June,debit,Going Out,21.77,,564.13
663,11/06/2018,June,debit,Going Out,26.47,,537.66
664,12/06/2018,June,debit,Savings,4.86,,532.8
665,12/06/2018,June,debit,Transport,3.4,,529.4
666,12/06/2018,June,debit,Going Out,28.42,,500.98
667,12/06/2018,June,debit,Going Out,3.92,,497.06
668,12/06/2018,June,debit,Others,0.11,,496.95
669,12/06/2018,June,debit,Others,0.5,,496.45
670,12/06/2018,June,debit,Going Out,2.54,,493.91
671,12/06/2018,June,debit,Others,0.07,,493.84
672,12/06/2018,June,debit,Others,0.5,,493.34
673,12/06/2018,June,debit,Others,1.41,,491.93
674,12/06/2018,June,debit,Others,0.04,,491.89
675,12/06/2018,June,debit,Others,0.5,,491.39
676,12/06/2018,June,debit,Transport,2.69,,488.7
677,12/06/2018,June,debit,Others,0.08,,488.62
678,12/06/2018,June,debit,Others,0.5,,488.12
679,12/06/2018,June,debit,Going Out,40.91,,447.21
680,13/06/2018,June,debit,Savings,2.71,,444.5
681,13/06/2018,June,debit,Going Out,5.59,,438.91
682,13/06/2018,June,debit,Others,0.16,,438.75
683,13/06/2018,June,debit,Others,0.5,,438.25
684,13/06/2018,June,debit,Transport,0.62,,437.63
685,13/06/2018,June,debit,Others,0.01,,437.62
686,13/06/2018,June,debit,Others,0.5,,437.12
687,13/06/2018,June,debit,Transport,5.45,,431.67
688,13/06/2018,June,debit,Others,0.16,,431.51
689,13/06/2018,June,debit,Others,0.5,,431.01
690,13/06/2018,June,debit,Transport,6.14,,424.87
691,13/06/2018,June,debit,Others,0.18,,424.69
692,13/06/2018,June,debit,Others,0.5,,424.19
693,13/06/2018,June,debit,Clothing,36.19,,388
694,13/06/2018,June,debit,Others,1.08,,386.92
695,13/06/2018,June,debit,Others,0.5,,386.42
696,13/06/2018,June,debit,Clothing,61.17,,325.25
697,14/06/2018,June,debit,Savings,3.84,,321.41
698,14/06/2018,June,debit,Going Out,7.65,,313.76
699,14/06/2018,June,debit,Others,0.22,,313.54
700,14/06/2018,June,debit,Others,0.5,,313.04
701,14/06/2018,June,debit,Transport,2.07,,310.97
702,14/06/2018,June,debit,Others,0.06,,310.91
703,14/06/2018,June,debit,Others,0.5,,310.41
704,14/06/2018,June,debit,Transport,3.21,,307.2
705,14/06/2018,June,debit,Others,0.09,,307.11
706,14/06/2018,June,debit,Others,0.5,,306.61
707,14/06/2018,June,debit,Coffee,3.51,,303.1
708,14/06/2018,June,debit,Others,0.1,,303
709,14/06/2018,June,debit,Others,0.5,,302.5
710,14/06/2018,June,debit,Entertainment,5.99,,296.51
711,14/06/2018,June,debit,Transport,5.53,,290.98
712,14/06/2018,June,debit,Others,0.16,,290.82
713,14/06/2018,June,debit,Others,0.5,,290.32
714,15/06/2018,June,debit,Savings,3.04,,287.28
715,15/06/2018,June,debit,Going Out,1.86,,285.42
716,15/06/2018,June,debit,Others,0.05,,285.37
717,15/06/2018,June,debit,Others,0.5,,284.87
718,15/06/2018,June,debit,Going Out,1.96,,282.91
719,15/06/2018,June,debit,Others,0.05,,282.86
720,15/06/2018,June,debit,Others,0.5,,282.36
721,15/06/2018,June,debit,Transport,2.07,,280.29
722,15/06/2018,June,debit,Others,0.06,,280.23
723,15/06/2018,June,debit,Others,0.5,,279.73
724,15/06/2018,June,debit,Transport,4.63,,275.1
725,15/06/2018,June,debit,Others,0.13,,274.97
726,15/06/2018,June,debit,Others,0.5,,274.47
727,15/06/2018,June,debit,Transport,4.98,,269.49
728,15/06/2018,June,debit,Others,0.14,,269.35
729,15/06/2018,June,debit,Others,0.5,,268.85
730,15/06/2018,June,debit,Going Out,24.28,,244.57
731,15/06/2018,June,debit,Going Out,59.61,,184.96
732,18/06/2018,June,debit,Savings,2.61,,182.35
733,18/06/2018,June,credit,Income (passive),,137.57,319.92
734,18/06/2018,June,debit,Transport,0.41,,319.51
735,18/06/2018,June,debit,Others,0.01,,319.5
736,18/06/2018,June,debit,Others,0.5,,319
737,18/06/2018,June,debit,Transport,2.05,,316.95
738,18/06/2018,June,debit,Others,0.06,,316.89
739,18/06/2018,June,debit,Others,0.5,,316.39
740,18/06/2018,June,debit,Transport,2.47,,313.92
741,18/06/2018,June,debit,Others,0.07,,313.85
742,18/06/2018,June,debit,Others,0.5,,313.35
743,18/06/2018,June,debit,Going Out,5.11,,308.24
744,18/06/2018,June,debit,Others,0.15,,308.09
745,18/06/2018,June,debit,Others,0.5,,307.59
746,18/06/2018,June,debit,Coffee,2.05,,305.54
747,18/06/2018,June,debit,Others,0.06,,305.48
748,18/06/2018,June,debit,Others,0.5,,304.98
749,18/06/2018,June,debit,Coffee,2.05,,302.93
750,18/06/2018,June,debit,Others,0.06,,302.87
751,18/06/2018,June,debit,Others,0.5,,302.37
752,18/06/2018,June,debit,Coffee,2.25,,300.12
753,18/06/2018,June,debit,Others,0.06,,300.06
754,18/06/2018,June,debit,Others,0.5,,299.56
755,18/06/2018,June,debit,Transport,3.43,,296.13
756,18/06/2018,June,debit,Others,0.1,,296.03
757,18/06/2018,June,debit,Others,0.5,,295.53
758,18/06/2018,June,debit,Going Out,3.43,,292.1
759,18/06/2018,June,debit,Going Out,3.04,,289.06
760,18/06/2018,June,debit,Transport,3.32,,285.74
761,18/06/2018,June,debit,Others,0.09,,285.65
762,18/06/2018,June,debit,Others,0.5,,285.15
763,18/06/2018,June,debit,Others,9.11,,276.04
764,18/06/2018,June,debit,Going Out,11.25,,264.79
765,18/06/2018,June,debit,Clothing,12.61,,252.18
766,18/06/2018,June,debit,Transport,24,,228.18
767,18/06/2018,June,debit,Healthcare,63.33,,164.85
768,18/06/2018,June,debit,Transport,0.41,,164.44
769,18/06/2018,June,debit,Others,0.01,,164.43
770,18/06/2018,June,debit,Others,0.5,,163.93
771,19/06/2018,June,debit,Savings,11.68,,152.25
772,19/06/2018,June,debit,Going Out,4.29,,147.96
773,19/06/2018,June,debit,Others,0.12,,147.84
774,19/06/2018,June,debit,Others,0.5,,147.34
775,19/06/2018,June,debit,Transport,8,,139.34
776,19/06/2018,June,debit,Others,0.23,,139.11
777,19/06/2018,June,debit,Others,0.5,,138.61
778,19/06/2018,June,debit,Transport,8.6,,130.01
779,20/06/2018,June,debit,Savings,1.11,,128.9
780,20/06/2018,June,debit,Healthcare,20,,108.9
781,20/06/2018,June,debit,Clothing,10.5,,98.4
782,21/06/2018,June,debit,Savings,0.5,,97.9
783,21/06/2018,June,debit,Going Out,19.05,,78.85
784,21/06/2018,June,debit,Coffee,1,,77.85
785,21/06/2018,June,debit,Transport,5.2,,72.65
786,22/06/2018,June,debit,Savings,1.75,,70.9
787,22/06/2018,June,debit,Groceries,10.6,,60.3
788,22/06/2018,June,credit,Income (passive),,200,260.3
789,22/06/2018,June,debit,Groceries,7.3,,253
790,22/06/2018,June,debit,Healthcare,9.05,,243.95
791,25/06/2018,June,debit,Savings,2.05,,241.9
792,25/06/2018,June,debit,Going Out,2.99,,238.91
793,25/06/2018,June,debit,Transport,3.4,,235.51
794,25/06/2018,June,debit,Rent,8.4,,227.11
795,25/06/2018,June,debit,Going Out,8.7,,218.41
796,25/06/2018,June,debit,Rent,8.99,,209.42
797,25/06/2018,June,debit,Going Out,10.4,,199.02
798,25/06/2018,June,debit,Rent,19.99,,179.03
799,25/06/2018,June,debit,Going Out,22.28,,156.75
800,25/06/2018,June,debit,Entertainment,79,,77.75
801,25/06/2018,June,debit,Groceries,6.67,,71.08
802,25/06/2018,June,debit,Clothing,11.31,,59.77
803,25/06/2018,June,debit,Others,0.33,,59.44
804,25/06/2018,June,debit,Others,0.5,,58.94
805,25/06/2018,June,debit,Clothing,11.34,,47.6
806,25/06/2018,June,debit,Others,0.33,,47.27
807,25/06/2018,June,debit,Others,0.5,,46.77
808,25/06/2018,June,debit,Clothing,15.16,,31.61
809,25/06/2018,June,debit,Others,0.45,,31.16
810,25/06/2018,June,debit,Others,0.5,,30.66
811,26/06/2018,June,debit,Savings,5.37,,25.29
812,26/06/2018,June,credit,Income (passive),,22.46,47.75
813,26/06/2018,June,debit,Transport,1.5,,46.25
814,27/06/2018,June,credit,Income (passive),,0.4,46.65
815,27/06/2018,June,debit,Savings,0.5,,46.15
816,27/06/2018,June,debit,Going Out,8.25,,37.9
817,27/06/2018,June,debit,Going Out,12.15,,25.75
818,27/06/2018,June,debit,Groceries,2.85,,22.9
819,28/06/2018,June,debit,Savings,1.75,,21.15
820,28/06/2018,June,debit,Going Out,3,,18.15
821,29/06/2018,June,credit,Income (active),,1479.85,1498
822,29/06/2018,June,debit,Transport,3.4,,1494.6
823,29/06/2018,June,debit,Going Out,6,,1488.6
824,02/07/2018,July,debit,Savings,0.6,,1488
825,02/07/2018,July,debit,Savings,50,,1438
826,02/07/2018,July,debit,Savings,300,,1138
827,02/07/2018,July,debit,Rent,150,,988
828,02/07/2018,July,debit,Bills,19,,969
829,02/07/2018,July,debit,Bills,33.07,,935.93
830,03/07/2018,July,debit,Transport,5.2,,930.73
831,04/07/2018,July,debit,Savings,0.8,,929.93
832,04/07/2018,July,debit,Transport,3.4,,926.53
833,04/07/2018,July,debit,Healthcare,20,,906.53
834,04/07/2018,July,debit,Groceries,17.55,,888.98
835,05/07/2018,July,debit,Savings,1.05,,887.93
836,05/07/2018,July,debit,Going Out,7.74,,880.19
837,06/07/2018,July,debit,Savings,0.26,,879.93
838,09/07/2018,July,debit,Others,13.99,,865.94
839,09/07/2018,July,debit,Rent,7.98,,857.96
840,10/07/2018,July,debit,Savings,0.02,,857.94
841,10/07/2018,July,debit,Transport,8.6,,849.34
842,10/07/2018,July,debit,Going Out,29.95,,819.39
843,10/07/2018,July,debit,Savings,100,,719.39
844,11/07/2018,July,debit,Savings,0.45,,718.94
845,11/07/2018,July,debit,Healthcare,50,,668.94
846,11/07/2018,July,debit,Transport,3.4,,665.54
847,11/07/2018,July,debit,Going Out,13.65,,651.89
848,11/07/2018,July,debit,Going Out,19.24,,632.65
849,11/07/2018,July,debit,Transport,1,,631.65
850,12/07/2018,July,debit,Savings,1.71,,629.94
851,12/07/2018,July,debit,Transport,11.49,,618.45
852,13/07/2018,July,debit,Savings,0.51,,617.94
853,13/07/2018,July,debit,Transport,5.2,,612.74
854,13/07/2018,July,debit,Groceries,5.85,,606.89
855,13/07/2018,July,debit,Transport,5.2,,601.69
856,16/07/2018,July,debit,Clothing,31.85,,569.84
857,16/07/2018,July,debit,Savings,1.9,,567.94
858,16/07/2018,July,debit,Entertainment,5.99,,561.95
859,16/07/2018,July,debit,Transport,8.6,,553.35
860,16/07/2018,July,debit,Going Out,14.1,,539.25
861,16/07/2018,July,debit,Going Out,20.32,,518.93
862,16/07/2018,July,debit,Going Out,22,,496.93
863,17/07/2018,July,debit,Savings,1.99,,494.94
864,17/07/2018,July,debit,Transport,8.6,,486.34
865,17/07/2018,July,debit,Going Out,9.6,,476.74
866,17/07/2018,July,debit,Going Out,12.85,,463.89
867,17/07/2018,July,debit,Going Out,21.64,,442.25
868,18/07/2018,July,debit,Savings,1.31,,440.94
869,18/07/2018,July,debit,Going Out,18,,422.94
870,18/07/2018,July,debit,Healthcare,50,,372.94
871,18/07/2018,July,debit,Groceries,5.55,,367.39
872,19/07/2018,July,debit,Savings,0.45,,366.94
873,19/07/2018,July,debit,Groceries,3.65,,363.29
874,19/07/2018,July,debit,Rent,6.85,,356.44
875,19/07/2018,July,debit,Rent,17.67,,338.77
876,20/07/2018,July,debit,Savings,0.83,,337.94
877,20/07/2018,July,debit,Transport,5.2,,332.74
878,20/07/2018,July,debit,Going Out,3.02,,329.72
879,20/07/2018,July,debit,Going Out,7.47,,322.25
880,20/07/2018,July,debit,Transport,8.6,,313.65
881,20/07/2018,July,debit,Clothing,15,,298.65
882,20/07/2018,July,debit,Clothing,25.2,,273.45
883,23/07/2018,July,debit,Healthcare,30,,243.45
884,23/07/2018,July,debit,Savings,3.51,,239.94
885,23/07/2018,July,debit,Transport,3.4,,236.54
886,23/07/2018,July,debit,Going Out,9.25,,227.29
887,23/07/2018,July,debit,Going Out,10.67,,216.62
888,23/07/2018,July,debit,Going Out,12.5,,204.12
889,23/07/2018,July,debit,Groceries,1.35,,202.77
890,23/07/2018,July,debit,Coffee,9.83,,192.94
891,23/07/2018,July,debit,Clothing,24.95,,167.99
892,23/07/2018,July,debit,Clothing,30,,137.99
893,24/07/2018,July,debit,Savings,3.05,,134.94
894,24/07/2018,July,debit,Going Out,20,,114.94
895,24/07/2018,July,debit,Going Out,7.08,,107.86
896,24/07/2018,July,debit,Transport,8.6,,99.26
897,25/07/2018,July,debit,Savings,1.32,,97.94
898,25/07/2018,July,debit,Going Out,14.19,,83.75
899,25/07/2018,July,debit,Going Out,3.11,,80.64
900,25/07/2018,July,debit,Going Out,3.83,,76.81
901,25/07/2018,July,debit,Groceries,4.5,,72.31
902,25/07/2018,July,debit,Transport,8.6,,63.71
903,26/07/2018,July,debit,Savings,2.77,,60.94
904,26/07/2018,July,debit,Going Out,0.89,,60.05
905,26/07/2018,July,debit,Coffee,1,,59.05
906,26/07/2018,July,debit,Groceries,1.5,,57.55
907,26/07/2018,July,debit,Going Out,6,,51.55
908,27/07/2018,July,debit,Savings,0.61,,50.94
909,27/07/2018,July,debit,Transport,10.1,,40.84
910,27/07/2018,July,credit,Income (passive),,100,140.84
911,27/07/2018,July,debit,Coffee,2.95,,137.89
912,27/07/2018,July,debit,Transport,5.2,,132.69
913,27/07/2018,July,debit,Going Out,9.38,,123.31
914,27/07/2018,July,debit,Healthcare,9.99,,113.32
915,30/07/2018,July,debit,Groceries,11.95,,101.37
916,30/07/2018,July,debit,Savings,2.43,,98.94
917,30/07/2018,July,debit,Going Out,1.99,,96.95
918,30/07/2018,July,debit,Transport,3.4,,93.55
919,30/07/2018,July,debit,Going Out,7.48,,86.07
920,30/07/2018,July,debit,Going Out,4.99,,81.08
921,30/07/2018,July,debit,Coffee,5.44,,75.64
922,31/07/2018,July,credit,Income (active),,1681.48,1757.12
923,31/07/2018,July,debit,Savings,1.7,,1755.42
924,31/07/2018,July,debit,Going Out,9.4,,1746.02
925,31/07/2018,July,debit,Going Out,9.79,,1736.23
926,31/07/2018,July,debit,Transport,8.5,,1727.73
927,31/07/2018,July,debit,Going Out,5,,1722.73
928,31/07/2018,July,debit,Transport,8.6,,1714.13
929,31/07/2018,July,debit,Going Out,13.6,,1700.53
930,01/08/2018,August,debit,Savings,2.11,,1698.42
931,01/08/2018,August,debit,Savings,50,,1648.42
932,01/08/2018,August,debit,Savings,350,,1298.42
933,01/08/2018,August,debit,Savings,250,,1048.42
934,01/08/2018,August,debit,Bills,19,,1029.42
935,01/08/2018,August,debit,Bills,31.05,,998.37
936,01/08/2018,August,debit,Savings,50,,948.37
937,01/08/2018,August,debit,Entertainment,2.54,,945.83
938,01/08/2018,August,debit,Going Out,10.25,,935.58
939,01/08/2018,August,debit,Healthcare,50,,885.58
940,02/08/2018,August,debit,Savings,1.21,,884.37
941,02/08/2018,August,debit,Rent,250,,634.37
942,02/08/2018,August,debit,Groceries,2.2,,632.17
943,02/08/2018,August,debit,Going Out,4.57,,627.6
944,02/08/2018,August,debit,Transport,5.2,,622.4
945,02/08/2018,August,debit,Going Out,5.5,,616.9
946,02/08/2018,August,debit,Groceries,5.94,,610.96
947,02/08/2018,August,debit,Groceries,11.31,,599.65
948,03/08/2018,August,debit,Savings,3.28,,596.37
949,03/08/2018,August,debit,Transport,8.6,,587.77
950,03/08/2018,August,debit,Going Out,21.7,,566.07
951,06/08/2018,August,debit,Going Out,7.44,,558.63
952,06/08/2018,August,debit,Savings,1.26,,557.37
953,06/08/2018,August,debit,Transport,5.2,,552.17
954,06/08/2018,August,debit,Coffee,2.85,,549.32
955,06/08/2018,August,debit,Groceries,9.05,,540.27
956,07/08/2018,August,debit,Savings,1.9,,538.37
957,07/08/2018,August,debit,Transport,8.6,,529.77
958,08/08/2018,August,debit,Savings,0.4,,529.37
959,08/08/2018,August,debit,Going Out,3.99,,525.38
960,08/08/2018,August,debit,Going Out,18.65,,506.73
961,08/08/2018,August,debit,Others,13.99,,492.74
962,08/08/2018,August,debit,Transport,8.6,,484.14
963,08/08/2018,August,debit,Healthcare,50,,434.14
964,09/08/2018,August,debit,Savings,0.76,,433.38
965,10/08/2018,August,debit,Transport,8.6,,424.78
966,10/08/2018,August,debit,Groceries,0.75,,424.03
967,10/08/2018,August,debit,Transport,8.6,,415.43
968,10/08/2018,August,debit,Going Out,9.71,,405.72
969,10/08/2018,August,debit,Rent,13,,392.72
970,10/08/2018,August,debit,Going Out,18.69,,374.03
971,10/08/2018,August,debit,Clothing,35.98,,338.05
972,13/08/2018,August,debit,Savings,1.67,,336.38
973,13/08/2018,August,debit,Transport,5.2,,331.18
974,13/08/2018,August,debit,Coffee,2.2,,328.98
975,13/08/2018,August,debit,Entertainment,1.59,,327.39
976,14/08/2018,August,debit,Savings,2.01,,325.38
977,14/08/2018,August,debit,Going Out,14.2,,311.18
978,14/08/2018,August,debit,Transport,3.4,,307.78
979,14/08/2018,August,debit,Entertainment,5.99,,301.79
980,14/08/2018,August,debit,Going Out,8.5,,293.29
981,14/08/2018,August,debit,Clothing,10.95,,282.34
982,14/08/2018,August,debit,Healthcare,20,,262.34
983,15/08/2018,August,debit,Savings,1.96,,260.38
984,15/08/2018,August,debit,Transport,8.6,,251.78
985,15/08/2018,August,debit,Transport,5.2,,246.58
986,15/08/2018,August,debit,Healthcare,9.45,,237.13
987,16/08/2018,August,debit,Savings,1.75,,235.38
988,16/08/2018,August,debit,Others,19.55,,215.83
989,16/08/2018,August,debit,Coffee,1,,214.83
990,16/08/2018,August,debit,Groceries,1.8,,213.03
991,16/08/2018,August,debit,Going Out,4.01,,209.02
992,17/08/2018,August,debit,Savings,1.64,,207.38
993,17/08/2018,August,debit,Transport,8.6,,198.78
994,17/08/2018,August,debit,Healthcare,50,,148.78
995,17/08/2018,August,debit,Going Out,6.48,,142.3
996,17/08/2018,August,debit,Transport,8.6,,133.7
997,17/08/2018,August,debit,Healthcare,44.98,,88.72
998,20/08/2018,August,credit,Income (passive),,99,187.72
999,20/08/2018,August,debit,Going Out,18.45,,169.27
1000,20/08/2018,August,debit,Savings,1.34,,167.93
1001,20/08/2018,August,debit,Coffee,2,,165.93
1002,20/08/2018,August,debit,Going Out,6.28,,159.65
1003,20/08/2018,August,debit,Going Out,9.4,,150.25
1004,20/08/2018,August,debit,Transport,10.1,,140.15
1005,20/08/2018,August,debit,Transport,6.8,,133.35
1006,20/08/2018,August,debit,Going Out,7.78,,125.57
1007,20/08/2018,August,debit,Going Out,3.11,,122.46
1008,20/08/2018,August,debit,Transport,6.8,,115.66
1009,21/08/2018,August,debit,Savings,3.73,,111.93
1010,21/08/2018,August,debit,Going Out,14.2,,97.73
1011,21/08/2018,August,debit,Going Out,7.76,,89.97
1012,21/08/2018,August,debit,Groceries,4.85,,85.12
1013,21/08/2018,August,debit,Transport,8.6,,76.52
1014,22/08/2018,August,debit,Savings,1.59,,74.93
1015,22/08/2018,August,credit,Income (passive),,200,274.93
1016,22/08/2018,August,debit,Healthcare,50,,224.93
1017,22/08/2018,August,debit,Coffee,4.45,,220.48
1018,22/08/2018,August,debit,Going Out,4.68,,215.8
1019,22/08/2018,August,debit,Going Out,5,,210.8
1020,22/08/2018,August,debit,Healthcare,7.68,,203.12
1021,23/08/2018,August,debit,Savings,1.19,,201.93
1022,23/08/2018,August,debit,Transport,8.6,,193.33
1023,23/08/2018,August,debit,Groceries,1.95,,191.38
1024,23/08/2018,August,debit,Transport,8.6,,182.78
1025,23/08/2018,August,debit,Going Out,10.45,,172.33
1026,23/08/2018,August,debit,Clothing,29.95,,142.38
1027,24/08/2018,August,debit,Savings,1.45,,140.93
1028,24/08/2018,August,debit,Going Out,3.69,,137.24
1029,24/08/2018,August,debit,Going Out,4.45,,132.79
1030,24/08/2018,August,debit,Going Out,7.99,,124.8
1031,28/08/2018,August,debit,Transport,8.6,,116.2
1032,28/08/2018,August,credit,Income (passive),,100,216.2
1033,28/08/2018,August,debit,Savings,1.27,,214.93
1034,28/08/2018,August,debit,Groceries,1,,213.93
1035,28/08/2018,August,debit,Healthcare,2.49,,211.44
1036,28/08/2018,August,debit,Going Out,5,,206.44
1037,28/08/2018,August,debit,Healthcare,9.98,,196.46
1038,28/08/2018,August,debit,Going Out,10.15,,186.31
1039,28/08/2018,August,debit,Going Out,10.5,,175.81
1040,28/08/2018,August,debit,Transport,11.4,,164.41
1041,28/08/2018,August,debit,Going Out,12.2,,152.21
1042,28/08/2018,August,debit,Going Out,8,,144.21
1043,28/08/2018,August,debit,Going Out,16.2,,128.01
1044,28/08/2018,August,debit,Clothing,2.75,,125.26
1045,28/08/2018,August,debit,Healthcare,9.29,,115.97
1046,29/08/2018,August,credit,Income (passive),,0.55,116.52
1047,29/08/2018,August,debit,Savings,5.04,,111.48
1048,29/08/2018,August,debit,Healthcare,50,,61.48
1049,29/08/2018,August,debit,Going Out,8.08,,53.4
1050,29/08/2018,August,debit,Going Out,11.2,,42.2
1051,30/08/2018,August,debit,Savings,1.72,,40.48
1052,30/08/2018,August,credit,Income (passive),,200,240.48
1053,30/08/2018,August,debit,Going Out,3.56,,236.92
1054,30/08/2018,August,debit,Going Out,5.47,,231.45
1055,30/08/2018,August,debit,Transport,5.8,,225.65
1056,30/08/2018,August,debit,Going Out,9.3,,216.35
1057,31/08/2018,August,credit,Income (active),,1607.95,1824.3
1058,31/08/2018,August,debit,Savings,1.87,,1822.43
1059,31/08/2018,August,debit,Transport,8.6,,1813.83
1060,31/08/2018,August,debit,Transport,8.6,,1805.23
1061,31/08/2018,August,debit,Going Out,25,,1780.23
1062,03/09/2018,September,debit,Groceries,8,,1772.23
1063,03/09/2018,September,debit,Savings,0.8,,1771.43
1064,03/09/2018,September,debit,Savings,50,,1721.43
1065,03/09/2018,September,debit,Savings,350,,1371.43
1066,03/09/2018,September,debit,Rent,250,,1121.43
1067,03/09/2018,September,debit,Savings,250,,871.43
1068,03/09/2018,September,debit,Bills,19,,852.43
1069,03/09/2018,September,debit,Bills,30.36,,822.07
1070,03/09/2018,September,debit,Transport,8.6,,813.47
1071,03/09/2018,September,debit,Going Out,9.4,,804.07
1072,03/09/2018,September,debit,Going Out,10.96,,793.11
1073,03/09/2018,September,debit,Coffee,6.7,,786.41
1074,03/09/2018,September,debit,Clothing,36,,750.41
1075,03/09/2018,September,debit,Rent,3.95,,746.46
1076,03/09/2018,September,debit,Rent,6.41,,740.05
1077,03/09/2018,September,debit,Rent,7.44,,732.61
1078,03/09/2018,September,debit,Rent,7.99,,724.62
1079,03/09/2018,September,debit,Rent,8.49,,716.13
1080,04/09/2018,September,debit,Savings,3.06,,713.07
1081,04/09/2018,September,debit,Going Out,25.95,,687.12
1082,04/09/2018,September,debit,Going Out,49.1,,638.02
1083,04/09/2018,September,debit,Groceries,3,,635.02
1084,04/09/2018,September,debit,Transport,3.4,,631.62
1085,05/09/2018,September,debit,Savings,1.55,,630.07
1086,05/09/2018,September,debit,Going Out,7.4,,622.67
1087,05/09/2018,September,debit,Healthcare,180,,442.67
1088,05/09/2018,September,debit,Going Out,4.01,,438.66
1089,05/09/2018,September,debit,Groceries,4.29,,434.37
1090,06/09/2018,September,debit,Savings,2.3,,432.07
1091,06/09/2018,September,debit,Groceries,7.35,,424.72
1092,07/09/2018,September,debit,Savings,0.65,,424.07
1093,07/09/2018,September,debit,Entertainment,4.16,,419.91
1094,10/09/2018,September,debit,Groceries,20,,399.91
1095,10/09/2018,September,debit,Savings,0.84,,399.07
1096,10/09/2018,September,debit,Entertainment,2.32,,396.75
1097,10/09/2018,September,debit,Transport,5.2,,391.55
1098,10/09/2018,September,debit,Going Out,8.5,,383.05
1099,10/09/2018,September,debit,Groceries,9.5,,373.55
1100,10/09/2018,September,debit,Going Out,11,,362.55
1101,10/09/2018,September,debit,Transport,3.4,,359.15
1102,11/09/2018,September,debit,Savings,3.08,,356.07
1103,11/09/2018,September,debit,Groceries,5.85,,350.22
1104,11/09/2018,September,debit,Entertainment,2.09,,348.13
1105,11/09/2018,September,debit,Transport,2.2,,345.93
1106,12/09/2018,September,debit,Savings,1.86,,344.07
1107,12/09/2018,September,debit,Others,19.04,,325.03
1108,12/09/2018,September,debit,Others,8.75,,316.28
1109,13/09/2018,September,debit,Savings,1.21,,315.07
1110,13/09/2018,September,debit,Transport,3.4,,311.67
1111,13/09/2018,September,debit,Entertainment,5.99,,305.68
1112,14/09/2018,September,debit,Savings,0.61,,305.07
1113,14/09/2018,September,debit,Groceries,55.63,,249.44
1114,17/09/2018,September,debit,Savings,0.37,,249.07
1115,17/09/2018,September,debit,Going Out,9.1,,239.97
1116,17/09/2018,September,debit,Transport,12.3,,227.67
1117,17/09/2018,September,debit,Going Out,15.86,,211.81
1118,17/09/2018,September,debit,Clothing,17.99,,193.82
1119,17/09/2018,September,debit,Clothing,23,,170.82
1120,17/09/2018,September,debit,Clothing,35.95,,134.87
1121,17/09/2018,September,debit,Entertainment,4.16,,130.71
1122,17/09/2018,September,debit,Transport,7.97,,122.74
1123,17/09/2018,September,debit,Groceries,6.14,,116.6
1124,18/09/2018,September,debit,Savings,3.53,,113.07
1125,18/09/2018,September,credit,Income (passive),,68.06,181.13
1126,19/09/2018,September,debit,Groceries,1.1,,180.03
1127,19/09/2018,September,debit,Others,1.2,,178.83
1128,19/09/2018,September,debit,Others,5,,173.83
1129,19/09/2018,September,debit,Entertainment,7.62,,166.21
1130,19/09/2018,September,debit,Others,0.22,,165.99
1131,19/09/2018,September,debit,Others,0.5,,165.49
1132,20/09/2018,September,debit,Savings,2.08,,163.41
1133,20/09/2018,September,debit,Going Out,4.29,,159.12
1134,20/09/2018,September,debit,Transport,8.6,,150.52
1135,20/09/2018,September,debit,Going Out,8.8,,141.72
1136,21/09/2018,September,debit,Savings,1.31,,140.41
1137,21/09/2018,September,debit,Groceries,12.15,,128.26
1138,21/09/2018,September,debit,Transport,5.2,,123.06
1139,24/09/2018,September,debit,Going Out,8.5,,114.56
1140,24/09/2018,September,debit,Savings,2.15,,112.41
1141,24/09/2018,September,debit,Transport,5.2,,107.21
1142,24/09/2018,September,debit,Going Out,9.4,,97.81
1143,24/09/2018,September,debit,Groceries,3.5,,94.31
1144,24/09/2018,September,debit,Others,5.5,,88.81
1145,24/09/2018,September,debit,Groceries,7.6,,81.21
1146,24/09/2018,September,debit,Groceries,14.55,,66.66
1147,24/09/2018,September,credit,Income (passive),,90,156.66
1148,25/09/2018,September,debit,Savings,3.25,,153.41
1149,25/09/2018,September,debit,Clothing,65,,88.41
1150,26/09/2018,September,debit,Going Out,5.6,,82.81
1151,26/09/2018,September,debit,Coffee,6.15,,76.66
1152,27/09/2018,September,debit,Savings,1.25,,75.41
1153,27/09/2018,September,debit,Transport,8.6,,66.81
1154,27/09/2018,September,debit,Groceries,1.3,,65.51
1155,27/09/2018,September,debit,Groceries,6.15,,59.36
1156,27/09/2018,September,debit,Transport,8.6,,50.76
1157,27/09/2018,September,debit,Going Out,13.9,,36.86
1158,28/09/2018,September,credit,Income (active),,1699.65,1736.51
1159,28/09/2018,September,debit,Savings,2.45,,1734.06
1160,28/09/2018,September,debit,Going Out,10.48,,1723.58
1161,28/09/2018,September,debit,Going Out,5.6,,1717.98
1162,28/09/2018,September,debit,Going Out,11.6,,1706.38
1163,01/10/2018,October,debit,Savings,1.32,,1705.06
1164,01/10/2018,October,debit,Savings,50,,1655.06
1165,01/10/2018,October,debit,Savings,350,,1305.06
1166,01/10/2018,October,debit,Savings,250,,1055.06
1167,01/10/2018,October,debit,Healthcare,20,,1035.06
1168,01/10/2018,October,debit,Going Out,3.89,,1031.17
1169,01/10/2018,October,debit,Transport,8.6,,1022.57
1170,01/10/2018,October,debit,Groceries,3,,1019.57
1171,01/10/2018,October,debit,Transport,5.2,,1014.37
1172,01/10/2018,October,debit,Groceries,5.45,,1008.92
1173,01/10/2018,October,debit,Going Out,5.5,,1003.42
1174,01/10/2018,October,debit,Going Out,3.35,,1000.07
1175,01/10/2018,October,debit,Transport,3.4,,996.67
1176,01/10/2018,October,debit,Rent,6.99,,989.68
1177,01/10/2018,October,debit,Going Out,8.25,,981.43
1178,01/10/2018,October,debit,Groceries,9.05,,972.38
1179,01/10/2018,October,debit,Going Out,19.35,,953.03
1180,01/10/2018,October,debit,Rent,24.2,,928.83
1181,02/10/2018,October,debit,Savings,6.77,,922.06
1182,02/10/2018,October,debit,Rent,250,,672.06
1183,02/10/2018,October,debit,Going Out,14.2,,657.86
1184,02/10/2018,October,debit,Going Out,9.4,,648.46
1185,02/10/2018,October,debit,Going Out,11.59,,636.87
1186,02/10/2018,October,debit,Bills,19,,617.87
1187,02/10/2018,October,debit,Bills,30.36,,587.51
1188,02/10/2018,October,debit,Transport,2.7,,584.81
1189,02/10/2018,October,debit,Transport,3.4,,581.41
1190,03/10/2018,October,debit,Savings,2.71,,578.7
1191,03/10/2018,October,debit,Going Out,6.48,,572.22
1192,03/10/2018,October,debit,Groceries,6.3,,565.92
1193,03/10/2018,October,debit,Groceries,2.55,,563.37
1194,03/10/2018,October,debit,Entertainment,3.99,,559.38
1195,03/10/2018,October,debit,Others,4,,555.38
1196,03/10/2018,October,debit,Groceries,8.3,,547.08
1197,03/10/2018,October,debit,Going Out,8.35,,538.73
1198,03/10/2018,October,debit,Transport,10.1,,528.63
1199,04/10/2018,October,debit,Savings,3.93,,524.7
1200,04/10/2018,October,debit,Entertainment,11.59,,513.11
1201,04/10/2018,October,debit,Others,0.34,,512.77
1202,04/10/2018,October,debit,Others,0.5,,512.27
1203,04/10/2018,October,debit,Going Out,1.9,,510.37
1204,04/10/2018,October,debit,Going Out,1.99,,508.38
1205,04/10/2018,October,debit,Groceries,5,,503.38
1206,04/10/2018,October,debit,Going Out,5.18,,498.2
1207,04/10/2018,October,debit,Transport,5.2,,493
1208,04/10/2018,October,debit,Going Out,7.4,,485.6
1209,04/10/2018,October,debit,Groceries,9.55,,476.05
1210,05/10/2018,October,debit,Savings,3.19,,472.86
1211,05/10/2018,October,debit,Healthcare,20.62,,452.24
1212,05/10/2018,October,debit,Coffee,4.94,,447.3
1213,08/10/2018,October,debit,Healthcare,40,,407.3
1214,08/10/2018,October,debit,Going Out,28.5,,378.8
1215,08/10/2018,October,debit,Going Out,28,,350.8
1216,08/10/2018,October,debit,Savings,0.44,,350.36
1217,08/10/2018,October,debit,Going Out,4.29,,346.07
1218,08/10/2018,October,debit,Groceries,6,,340.07
1219,08/10/2018,October,debit,Going Out,11.47,,328.6
1220,08/10/2018,October,debit,Groceries,24.29,,304.31
1221,09/10/2018,October,debit,Savings,1.95,,302.36
1222,09/10/2018,October,debit,Transport,5.2,,297.16
1223,09/10/2018,October,debit,Clothing,7,,290.16
1224,09/10/2018,October,debit,Groceries,1.65,,288.51
1225,09/10/2018,October,debit,Rent,7.99,,280.52
1226,10/10/2018,October,debit,Savings,1.16,,279.36
1227,10/10/2018,October,debit,Transport,3.4,,275.96
1228,10/10/2018,October,debit,Going Out,11.69,,264.27
1229,10/10/2018,October,debit,Healthcare,50,,214.27
1230,10/10/2018,October,debit,Groceries,2.35,,211.92
1231,10/10/2018,October,debit,Going Out,3.56,,208.36
1232,11/10/2018,October,debit,Savings,2,,206.36
1233,11/10/2018,October,debit,Transport,12.1,,194.26
1234,11/10/2018,October,debit,Going Out,4.39,,189.87
1235,12/10/2018,October,debit,Savings,1.51,,188.36
1236,12/10/2018,October,debit,Transport,6.8,,181.56
1237,12/10/2018,October,debit,Healthcare,11.58,,169.98
1238,15/10/2018,October,debit,Transport,8.6,,161.38
1239,15/10/2018,October,debit,Savings,1.02,,160.36
1240,15/10/2018,October,debit,Going Out,5.98,,154.38
1241,15/10/2018,October,debit,Entertainment,5.99,,148.39
1242,16/10/2018,October,debit,Savings,0.03,,148.36
1243,16/10/2018,October,debit,Transport,3.4,,144.96
1244,16/10/2018,October,debit,Groceries,15.05,,129.91
1245,16/10/2018,October,debit,Groceries,4.6,,125.31
1246,16/10/2018,October,debit,Groceries,7.05,,118.26
1247,17/10/2018,October,debit,Savings,2.9,,115.36
1248,17/10/2018,October,debit,Transport,3.4,,111.96
1249,17/10/2018,October,debit,Groceries,4.6,,107.36
1250,17/10/2018,October,debit,Transport,8.6,,98.76
1251,18/10/2018,October,debit,Savings,1.4,,97.36
1252,18/10/2018,October,debit,Groceries,8.85,,88.51
1253,19/10/2018,October,debit,Savings,0.15,,88.36
1254,19/10/2018,October,debit,Transport,8.6,,79.76
1255,22/10/2018,October,debit,Savings,0.4,,79.36
1256,25/10/2018,October,credit,Income (passive),,50,129.36
1257,26/10/2018,October,debit,Healthcare,10,,119.36
1258,29/10/2018,October,debit,Going Out,28,,91.36
1259,29/10/2018,October,credit,Income (passive),,100,191.36
1260,29/10/2018,October,debit,Going Out,25.35,,166.01
1261,29/10/2018,October,debit,Transport,5.2,,160.81
1262,29/10/2018,October,debit,Groceries,10.5,,150.31
1263,29/10/2018,October,debit,Coffee,5.44,,144.87
1264,29/10/2018,October,debit,Groceries,7.1,,137.77
1265,29/10/2018,October,debit,Clothing,15.04,,122.73
1266,29/10/2018,October,debit,Groceries,4.88,,117.85
1267,30/10/2018,October,debit,Savings,3.84,,114.01
1268,30/10/2018,October,debit,Healthcare,40,,74.01
1269,30/10/2018,October,debit,Groceries,12.45,,61.56
1270,30/10/2018,October,debit,Others,34.91,,26.65
1271,31/10/2018,October,credit,Income (active),,1624.15,1650.8
1272,31/10/2018,October,debit,Savings,0.55,,1650.25
1273,31/10/2018,October,debit,Healthcare,40,,1610.25
1274,31/10/2018,October,debit,Groceries,0.45,,1609.8
1275,01/11/2018,November,debit,Savings,0.55,,1609.25
1276,01/11/2018,November,debit,Savings,50,,1559.25
1277,01/11/2018,November,debit,Savings,350,,1209.25
1278,01/11/2018,November,debit,Savings,250,,959.25
1279,01/11/2018,November,debit,Transport,8.6,,950.65
1280,01/11/2018,November,debit,Bills,19,,931.65
1281,01/11/2018,November,debit,Bills,30.36,,901.29
1282,01/11/2018,November,debit,Savings,875,,26.29
1283,02/11/2018,November,debit,Savings,0.4,,25.89
1284,02/11/2018,November,credit,Income (passive),,75,100.89
1285,02/11/2018,November,debit,Groceries,3.7,,97.19
1286,02/11/2018,November,debit,Going Out,7.88,,89.31
1287,02/11/2018,November,debit,Groceries,12.25,,77.06
1288,05/11/2018,November,debit,Transport,5.2,,71.86
1289,05/11/2018,November,credit,Income (passive),,500,571.86
1290,05/11/2018,November,debit,Healthcare,50,,521.86
1291,05/11/2018,November,debit,Going Out,27,,494.86
1292,05/11/2018,November,debit,Savings,1.97,,492.89
1293,05/11/2018,November,debit,Rent,250,,242.89
1294,05/11/2018,November,debit,Transport,85.2,,157.69
1295,05/11/2018,November,debit,Groceries,16.5,,141.19
1296,05/11/2018,November,debit,Going Out,6,,135.19
1297,05/11/2018,November,debit,Groceries,8,,127.19
1298,05/11/2018,November,debit,Transport,2.7,,124.49
1299,05/11/2018,November,debit,Going Out,12,,112.49
1300,05/11/2018,November,debit,Others,20.1,,92.39
1301,05/11/2018,November,credit,Income (passive),,300,392.39
1302,06/11/2018,November,debit,Savings,1.2,,391.19
1303,07/11/2018,November,debit,Others,31.27,,359.92
1304,07/11/2018,November,debit,Others,97,,262.92
1305,07/11/2018,November,debit,Going Out,5,,257.92
1306,07/11/2018,November,debit,Groceries,8.5,,249.42
1307,08/11/2018,November,debit,Savings,1.23,,248.19
1308,08/11/2018,November,debit,Transport,8.6,,239.59
1309,08/11/2018,November,debit,Groceries,1.4,,238.19
1310,08/11/2018,November,debit,Groceries,5.5,,232.69
1311,09/11/2018,November,debit,Savings,1.5,,231.19
1312,09/11/2018,November,debit,Transport,5.2,,225.99
1313,09/11/2018,November,debit,Coffee,3.65,,222.34
1314,09/11/2018,November,debit,Groceries,4.55,,217.79
1315,09/11/2018,November,debit,Groceries,12.95,,204.84
1316,09/11/2018,November,debit,Clothing,38.9,,165.94
1317,12/11/2018,November,debit,Going Out,27.9,,138.04
1318,12/11/2018,November,debit,Savings,1.75,,136.29
1319,12/11/2018,November,debit,Transport,3.4,,132.89
1320,12/11/2018,November,debit,Groceries,3.6,,129.29
1321,12/11/2018,November,debit,Groceries,7.2,,122.09
1322,12/11/2018,November,debit,Going Out,10.75,,111.34
1323,12/11/2018,November,debit,Going Out,9.8,,101.54
1324,12/11/2018,November,debit,Clothing,9.9,,91.64
1325,12/11/2018,November,debit,Clothing,6.95,,84.69
1326,12/11/2018,November,debit,Clothing,9.74,,74.95
1327,13/11/2018,November,debit,Savings,2.66,,72.29
1328,13/11/2018,November,debit,Transport,5.2,,67.09
1329,13/11/2018,November,debit,Going Out,5.5,,61.59
1330,14/11/2018,November,debit,Savings,1.3,,60.29
1331,14/11/2018,November,debit,Transport,8.6,,51.69
1332,14/11/2018,November,credit,Income (passive),,100,151.69
1333,14/11/2018,November,debit,Entertainment,5.99,,145.7
1334,14/11/2018,November,debit,Groceries,8,,137.7
1335,15/11/2018,November,debit,Savings,0.41,,137.29
1336,15/11/2018,November,debit,Transport,13.8,,123.49
1337,15/11/2018,November,debit,Going Out,3.11,,120.38
1338,15/11/2018,November,debit,Groceries,3.8,,116.58
1339,16/11/2018,November,debit,Savings,1.29,,115.29
1340,16/11/2018,November,debit,Transport,8.6,,106.69
1341,16/11/2018,November,debit,Going Out,8.06,,98.63
1342,16/11/2018,November,debit,Transport,8.6,,90.03
1343,19/11/2018,November,debit,Savings,1.74,,88.29
1344,19/11/2018,November,debit,Groceries,2,,86.29
1345,19/11/2018,November,debit,Going Out,8.6,,77.69
1346,19/11/2018,November,debit,Going Out,1,,76.69
1347,20/11/2018,November,debit,Savings,0.4,,76.29
1348,20/11/2018,November,debit,Transport,5.2,,71.09
1349,20/11/2018,November,debit,Groceries,1.25,,69.84
1350,20/11/2018,November,debit,Groceries,3.7,,66.14
1351,21/11/2018,November,debit,Savings,1.85,,64.29
1352,21/11/2018,November,debit,Transport,3.4,,60.89
1353,22/11/2018,November,debit,Savings,0.6,,60.29
1354,22/11/2018,November,debit,Transport,8.6,,51.69
1355,23/11/2018,November,debit,Savings,0.4,,51.29
1356,26/11/2018,November,credit,Income (passive),,250,301.29
1357,26/11/2018,November,debit,Going Out,4.65,,296.64
1358,26/11/2018,November,debit,Groceries,8.95,,287.69
1359,26/11/2018,November,debit,Clothing,12.95,,274.74
1360,26/11/2018,November,debit,Going Out,29.7,,245.04
1361,26/11/2018,November,credit,Income (passive),,74,319.04
1362,27/11/2018,November,debit,Savings,0.75,,318.29
1363,27/11/2018,November,debit,Transport,8.6,,309.69
1364,27/11/2018,November,debit,Coffee,2.95,,306.74
1365,27/11/2018,November,debit,Clothing,21.4,,285.34
1366,27/11/2018,November,credit,Income (passive),,11,296.34
1367,28/11/2018,November,debit,Savings,1.05,,295.29
1368,28/11/2018,November,debit,Transport,3.4,,291.89
1369,28/11/2018,November,debit,Healthcare,50,,241.89
1370,28/11/2018,November,debit,Rent,3.29,,238.6
1371,28/11/2018,November,debit,Groceries,3.4,,235.2
1372,28/11/2018,November,debit,Rent,3.99,,231.21
1373,28/11/2018,November,debit,Transport,8.6,,222.61
1374,28/11/2018,November,debit,Rent,14.83,,207.78
1375,28/11/2018,November,debit,Rent,21.41,,186.37
1376,29/11/2018,November,debit,Savings,3.08,,183.29
1377,29/11/2018,November,debit,Rent,114.43,,68.86
1378,29/11/2018,November,debit,Groceries,2.1,,66.76
1379,29/11/2018,November,debit,Groceries,2.8,,63.96
1380,29/11/2018,November,debit,Rent,10.99,,52.97
1381,30/11/2018,November,credit,Income (active),,1501.79,1554.76
1382,30/11/2018,November,debit,Savings,1.68,,1553.08
1383,30/11/2018,November,debit,Transport,5.2,,1547.88
1384,30/11/2018,November,debit,Going Out,3.56,,1544.32
1385,30/11/2018,November,debit,Going Out,5.88,,1538.44
1386,30/11/2018,November,debit,Groceries,8,,1530.44
1387,03/12/2018,December,debit,Transport,6.9,,1523.54
1388,03/12/2018,December,debit,Savings,1.46,,1522.08
1389,03/12/2018,December,debit,Savings,50,,1472.08
1390,03/12/2018,December,debit,Savings,350,,1122.08
1391,03/12/2018,December,debit,Rent,250,,872.08
1392,03/12/2018,December,debit,Savings,250,,622.08
1393,03/12/2018,December,debit,Bills,19,,603.08
1394,03/12/2018,December,debit,Bills,32.36,,570.72
1395,03/12/2018,December,debit,Going Out,2.99,,567.73
1396,03/12/2018,December,debit,Going Out,5,,562.73
1397,03/12/2018,December,debit,Transport,5.2,,557.53
1398,03/12/2018,December,debit,Groceries,15.45,,542.08
1399,03/12/2018,December,debit,Going Out,17.98,,524.1
1400,03/12/2018,December,debit,Groceries,2,,522.1
1401,03/12/2018,December,debit,Clothing,35.04,,487.06
1402,03/12/2018,December,debit,Clothing,45,,442.06
1403,03/12/2018,December,debit,Groceries,1.75,,440.31
1404,04/12/2018,December,debit,Savings,2.59,,437.72
1405,04/12/2018,December,debit,Going Out,11.16,,426.56
1406,04/12/2018,December,debit,Coffee,2.75,,423.81
1407,04/12/2018,December,debit,Groceries,8.72,,415.09
1408,05/12/2018,December,debit,Savings,1.37,,413.72
1409,05/12/2018,December,debit,Going Out,7.78,,405.94
1410,05/12/2018,December,debit,Rent,9.31,,396.63
1411,05/12/2018,December,debit,Rent,9.31,,387.32
1412,05/12/2018,December,debit,Rent,25.18,,362.14
1413,05/12/2018,December,debit,Others,15,,347.14
1414,06/12/2018,December,debit,Savings,2.42,,344.72
1415,06/12/2018,December,debit,Transport,5.2,,339.52
1416,06/12/2018,December,debit,Going Out,3.11,,336.41
1417,06/12/2018,December,debit,Going Out,3.89,,332.52
1418,06/12/2018,December,debit,Rent,11.99,,320.53
1419,07/12/2018,December,debit,Savings,1.81,,318.72
1420,07/12/2018,December,debit,Transport,3.4,,315.32
1421,07/12/2018,December,debit,Rent,4.49,,310.83
1422,10/12/2018,December,debit,Savings,1.11,,309.72
1423,10/12/2018,December,debit,Groceries,19,,290.72
1424,10/12/2018,December,debit,Going Out,5.5,,285.22
1425,10/12/2018,December,debit,Transport,8.6,,276.62
1426,10/12/2018,December,debit,Groceries,0.5,,276.12
1427,10/12/2018,December,debit,Groceries,4.65,,271.47
1428,11/12/2018,December,debit,Savings,1.75,,269.72
1429,11/12/2018,December,debit,Transport,5.2,,264.52
1430,11/12/2018,December,debit,Groceries,8,,256.52
1431,12/12/2018,December,debit,Savings,0.8,,255.72
1432,12/12/2018,December,debit,Healthcare,50,,205.72
1433,13/12/2018,December,debit,Groceries,11.05,,194.67
1434,14/12/2018,December,debit,Savings,0.95,,193.72
1435,14/12/2018,December,debit,Transport,5.2,,188.52
1436,14/12/2018,December,debit,Entertainment,5.99,,182.53
1437,17/12/2018,December,debit,Transport,3.4,,179.13
1438,17/12/2018,December,debit,Savings,1.41,,177.72
1439,17/12/2018,December,debit,Going Out,3.98,,173.74
1440,17/12/2018,December,debit,Going Out,5.25,,168.49
1441,17/12/2018,December,debit,Transport,5.8,,162.69
1442,17/12/2018,December,debit,Going Out,8.5,,154.19
1443,18/12/2018,December,debit,Savings,1.47,,152.72
1444,19/12/2018,December,credit,Income (active),,1464.22,1616.94
1445,19/12/2018,December,credit,Income (passive),,110,1726.94
1446,20/12/2018,December,debit,Groceries,3.5,,1723.44
1447,20/12/2018,December,debit,Transport,182.18,,1541.26
1448,21/12/2018,December,debit,Savings,1.32,,1539.94
1449,21/12/2018,December,debit,Groceries,8.9,,1531.04
1450,24/12/2018,December,debit,Savings,0.1,,1530.94
1451,24/12/2018,December,debit,Going Out,2,,1528.94
1452,24/12/2018,December,debit,Going Out,11.6,,1517.34
1453,24/12/2018,December,debit,Going Out,4.97,,1512.37
1454,24/12/2018,December,debit,Transport,8.3,,1504.07
1455,27/12/2018,December,debit,Transport,9.6,,1494.47
1456,27/12/2018,December,debit,Savings,1.53,,1492.94
1457,27/12/2018,December,debit,Coffee,7.6,,1485.34
1458,27/12/2018,December,debit,Groceries,2,,1483.34
1459,27/12/2018,December,debit,Coffee,3.05,,1480.29
1460,27/12/2018,December,debit,Entertainment,5.99,,1474.3
1461,27/12/2018,December,debit,Rent,6.99,,1467.31
1462,27/12/2018,December,debit,Rent,9.99,,1457.32
1463,27/12/2018,December,debit,Entertainment,17.99,,1439.33
1464,27/12/2018,December,debit,Rent,22.99,,1416.34
1465,27/12/2018,December,debit,Entertainment,50,,1366.34
1466,28/12/2018,December,debit,Savings,1.4,,1364.94
1467,28/12/2018,December,debit,Entertainment,23.97,,1340.97
1468,31/12/2018,December,debit,Going Out,20,,1320.97
1469,31/12/2018,December,debit,Savings,0.03,,1320.94
1470,31/12/2018,December,debit,Groceries,16.95,,1303.99
1471,31/12/2018,December,debit,Clothing,3.97,,1300.02
1472,31/12/2018,December,debit,Groceries,4.04,,1295.98